XXXXXXXXXX
X        X
X XXX X XX
X   X X  X
XXX X XX X
s X xXX  X
X     X XX
XXXXXXXzXX